hola=hello;
bien=good;
carro=car;
adios=bye;
llaves=key;
limpio=clean;
lapiz=pen;
papel=paper;
telefono=phone;
cuarto=room;
fuego=fire;
conjunto=set;
juego=play;
memory=memoria;
book=libro;
calculator=calculadora;
restroom=ba¤o;
police=policia;
with=con;
spanish=espa¤ol;
calculator=calculadora;
english=ingl‚s;
restaurant=restaurant;
car=carro;
fly=volar;
eat=comer;
meat=carne;
soccer=futbol;
computer=computadora;
pen=lapiz;
