hello=hola;
good=bien;
car=carro;
bye=adios;
key=llaves;
clean=limpio;
pen=lapiz;
paper=papel;
phone=telefono;
room=cuarto;
fire=fuego;
set=conjunto;
play=juego;
memoria=memory;
libro=book;
why=por;
calculadora=calculator;
ba¤o=restroom;
policia=police;
con=with;
espa¤ol=spanish;
calculadora=calculator;
ingl‚s=english;
restaurant=restaurant;
carro=car;
volar=fly;
comer=eat;
carne=meat;
futbol=soccer;
computadora=computer;
lapiz=pen;
